NNNNhNNHNHNNNNNN
NNNNhNNHNHNNNNNN
NNNChNNHNHNNNNNN
NNNNhNNNNHNNEEEE
NNNNhNNNNDNNEEEE
pppphpppppppEEEE
SSSShSSSSDSSEEEE
SSSShSSSSHSSEEEE
SSSChSSHSHSSSSSS
SSSShSSHSHSSSSSS
SSSShSSHSHSSSSSS
